10
-.G.P.-.-.-.P.-.-.A
-.-.-.-.-.-.-.-.-.-
-.-.-.-.-.-.-.-.G.-
-.G.-.-.G.-.P.-.-.G
-.-.G.-.P.-.-.-.-.-
-.-.-.-.G.-.-.-.W.-
-.-.W.-.-.G.-.-.G.G
-.-.-.G.-.-.P.-.-.-
-.-.-.-.-.-.-.G.-.P
-.P.-.G.-.-.-.-.G.-