10
A.-.-.-.-.-.-.-.-.G
-.-.-.-.B.-.-.-.-.-
-.-.-.B.P.B.-.-.-.-
-.-.-.-.GB.-.-.-.-.-
-.-.-.-.-.-.-.-.-.-
-.-.S.-.S.-.S.-.B.-
G.S.W.SS.W.SS.W.BS.P.-
-.-.S.-.S.-.S.-.B.-
-.-.G.-.G.-.G.-.G.-
-.-.-.-.-.-.-.-.-.-