10
A.-.-.G.-.-.G.-.-.G
-.B.-.-.B.-.-.-.-.-
B.P.B.B.P.B.-.-.-.-
-.B.-.-.GB.-.-.-.-.-
-.-.-.-.-.-.-.-.-.-
-.-.S.-.S.-.S.-.B.-
G.S.W.SS.W.SS.W.BS.P.-
-.-.S.-.S.-.S.-.B.-
-.-.G.-.G.-.G.-.G.-
-.-.-.-.-.-.-.-.-.-