10
-.-.-.-.G.-.-.-.-.-
-.-.-.-.G.S.-.-.-.-
-.-.B.-.GS.W.S.B.-.-
-.B.P.B.G.S.B.P.B.-
G.S.B.-.G.-.-.B.-.G
S.W.BS.G.G.G.-.-.-.-
G.S.-.-.G.-.-.-.B.G
-.-.-.-.G.-.-.B.P.B
-.-.-.-.G.-.-.-.B.-
-.-.-.-.G.-.-.-.-.A